%%%%%%%%%%%%%%%%%%%%%%%%%%%%%%%%%%%%%%%%%%%%%%%%%
%    %.        %             %  .%     % %   %  %
%    %%%% %%%%%% %  % % %%         %%%%  %. %%% %
%    %.%    %  % %  % %  %   %   %          %   %
%   .            %.     %%%% %   %%  %%% %      %
% %%%%% %%%%%%  %%%% %            %    %. %%%%%%%
%       %   .%       .% %%%  %%%%%%  % %  %   % %
%%% %%  % %%%%%%% %%%%% %    %    %% % %    % % %
%    %  %      %  %      P% %%       %   %%%% % %
%.      %   %  %  %     %          %       .%   %
% % %%%    % %    %% %% %%% %% %  %.%%%%%%%%%%% %
%   %    %    %              %    %             %
%%%%%%%%%%%%%%%%%%%%%%%%%%%%%%%%%%%%%%%%%%%%%%%%%
